USERNAME : PASSWORD
<blank> : <blank>
ADAMS : WOOD
ADLDEMO : ADLDEMO
ADMIN : JETSPEED
ADMIN : WELCOME
ADMINISTRATOR : ADMINISTRATOR
ADMINISTRATOR : admin
ANDY : SWORDFISH
AP : AP
APPLSYS : APPLSYS
APPLSYS : FND
APPLSYSPUB : FNDPUB
APPS : APPS
APPUSER : APPUSER
AQ : AQ
AQDEMO : AQDEMO
AQJAVA : AQJAVA
AQUSER : AQUSER
AUDIOUSER : AUDIOUSER
AURORA$JIS$UTILITY$ : <blank>
AURORA$ORB$UNAUTHENTICATED : INVALID
AURORA@ORB@UNAUTHENTICATED : INVALID
BC4J : BC4J
BLAKE : PAPER
BRIO_ADMIN : BRIO_ADMIN
CATALOG : CATALOG
CDEMO82 : CDEMO82
CDEMOCOR : CDEMOCOR
CDEMORID : CDEMORID
CDEMOUCB : CDEMOUCB
CENTRA : CENTRA
CIDS : CIDS
CIS : CIS
CISINFO : CISINFO
CLARK : CLOTH
COMPANY : COMPANY
COMPIERE : COMPIERE
CQSCHEMAUSER : PASSWORD
CSMIG : CSMIG
CTXDEMO : CTXDEMO
CTXSYS : <blank>
CTXSYS : CTXSYS
DBI : MUMBLEFRATZ
DBSNMP : DBSNMP
DEMO : DEMO
DEMO8 : DEMO8
DEMO9 : DEMO9
DES : DES
DEV2000_DEMOS : DEV2000_DEMOS
DIP : DIP
DISCOVERER_ADMIN : DISCOVERER_ADMIN
DSGATEWAY : DSGATEWAY
DSSYS : DSSYS
EJSADMIN : EJSADMIN
EMP : EMP
ESTOREUSER : ESTORE
EVENT : EVENT
EXFSYS : EXFSYS
FINANCE : FINANCE
FND : FND
FROSTY : SNOWMAN
GL : GL
GPFD : GPFD
GPLD : GPLD
HCPARK : HCPARK
HLW : HLW
HR : HR
IMAGEUSER : IMAGEUSER
IMEDIA : IMEDIA
JMUSER : JMUSER
JONES : STEEL
JWARD : AIROPLANE
L2LDEMO : L2LDEMO
LBACSYS : LBACSYS
LIBRARIAN : SHELVES
MASTER : PASSWORD
MDDEMO : MDDEMO
MDDEMO_CLERK : CLERK
MDDEMO_MGR : MGR
MDSYS : MDSYS
MFG : MFG
MGWUSER : MGWUSER
MIGRATE : MIGRATE
MILLER : MILLER
MMO2 : MMO2
MODTEST : YES
MOREAU : MOREAU
MTSSYS : MTSSYS
MTS_USER : MTS_PASSWORD
MTYSYS : MTYSYS
MXAGENT : MXAGENT
NAMES : NAMES
OAS_PUBLIC : OAS_PUBLIC
OCITEST : OCITEST
ODM : ODM
ODM_MTR : MTRPW
ODS : ODS
ODSCOMMON : ODSCOMMON
OE : OE
OEMADM : OEMADM
OEMREP : OEMREP
OLAPDBA : OLAPDBA
OLAPSVR : INSTANCE
OLAPSYS : MANAGER
OMWB_EMULATION : ORACLE
OO : OO
OPENSPIRIT : OPENSPIRIT
ORACACHE : (random password)
ORAREGSYS : ORAREGSYS
ORASSO : ORASSO
ORDPLUGINS : ORDPLUGINS
ORDSYS : ORDSYS
OSE$HTTP$ADMIN : (random password)
OSP22 : OSP22
OUTLN : OUTLN
OWA : OWA
OWA_PUBLIC : OWA_PUBLIC
OWNER : OWNER
PANAMA : PANAMA
PATROL : PATROL
PERFSTAT : PERFSTAT
PLEX : PLEX
PLSQL : SUPERSECRET
PM : PM
PO : PO
PO7 : PO7
PO8 : PO8
PORTAL30 : PORTAL30
PORTAL30 : PORTAL31
PORTAL30_DEMO : PORTAL30_DEMO
PORTAL30_PUBLIC : PORTAL30_PUBLIC
PORTAL30_SSO : PORTAL30_SSO
PORTAL30_SSO_PS : PORTAL30_SSO_PS
PORTAL30_SSO_PUBLIC : PORTAL30_SSO_PUBLIC
POWERCARTUSER : POWERCARTUSER
PRIMARY : PRIMARY
PUBSUB : PUBSUB
PUBSUB1 : PUBSUB1
QDBA : QDBA
QS : QS
QS_ADM : QS_ADM
QS_CB : QS_CB
QS_CBADM : QS_CBADM
QS_CS : QS_CS
QS_ES : QS_ES
QS_OS : QS_OS
QS_WS : QS_WS
RE : RE
REPADMIN : REPADMIN
REPORTS_USER : OEM_TEMP
REP_MANAGER : DEMO
REP_OWNER : DEMO
REP_OWNER : REP_OWNER
RMAIL : RMAIL
RMAN : RMAN
SAMPLE : SAMPLE
SAP : SAPR3
SCOTT : TIGER
SDOS_ICSAP : SDOS_ICSAP
SECDEMO : SECDEMO
SERVICECONSUMER1 : SERVICECONSUMER1
SH : SH
SITEMINDER : SITEMINDER
SLIDE : SLIDEPW
STARTER : STARTER
STRAT_USER : STRAT_PASSWD
SWPRO : SWPRO
SWUSER : SWUSER
SYMPA : SYMPA
SYS : CHANGE_ON_INSTALL
SYS : D_SYSPW
SYSADM : SYSADM
SYSMAN : OEM_TEMP
SYSMAN : oem_temp
SYSTEM : D_SYSTPW
SYSTEM : MANAGER
TAHITI : TAHITI
TDOS_ICSAP : TDOS_ICSAP
TESTPILOT : TESTPILOT
TRACESRV : TRACE
TRACESVR : TRACE
TRAVEL : TRAVEL
TSDEV : TSDEV
TSUSER : TSUSER
TURBINE : TURBINE
ULTIMATE : ULTIMATE
USER : USER
USER0 : USER0
USER1 : USER1
USER2 : USER2
USER3 : USER3
USER4 : USER4
USER5 : USER5
USER6 : USER6
USER7 : USER7
USER8 : USER8
USER9 : USER9
UTLBSTATU : UTLESTAT
VIDEOUSER : VIDEO USER
VIF_DEVELOPER : VIF_DEV_PWD
VIRUSER : VIRUSER
VRR1 : VRR1
WEBCAL01 : WEBCAL01
WEBDB : WEBDB
WEBREAD : WEBREAD
WKSYS : WKSYS
WWW : WWW
WWWUSER : WWWUSER
XPRT : XPRT
admin : admin
admin : adminadmin
admin : security
admin : welcome
bpel : bpel
cn=orcladmin : welcome
demo : demo
ilom-admin : ilom-admin
ilom-operator : ilom-operator
internal : oracle
joe : password
mary : password
nm2user : nm2user
oracle : oracle
scott : tiger or tigger
siteadmin : siteadmin
sys : change_on_install
sys : sys
system : manager
system : password
system : security
system/manager : sys/change_on_install
webdb : webdb
webgb : webdb
weblogic : weblogic
wlcsystem : wlcsystem
wlpisystem : wlpisystem
admin : <blank>
admin : admin
